10 10
 *   **/**
 * *      
 * * ***  
 * *****  
       *  
** * *  * 
 * * * *  
     */***
**** *    
         