12 7
     *******
****       * 
 * * ***** *
 * */*** * * 
   *  *    *
 * * **/** *
******   *** 
