10 7
     *** *
** *     * 
 * * *** *
 * ***** * 
   *     * 
 *** *  ** 
 * * * * * 
